4 4 4 4 4 4 4 4 4 4 4 4 4 4 4 2 2 2 2 2 2 2 2 2 2 2 2 2 2 2 4 2 4 4 4 4 4 4 4 4 4 4 4 4 4 4 4 4 4 4
4 4 4 4 4 4 4 4 4 4 4 4 4 4 4 6 2 2 2 2 2 2 2 2 2 2 2 2 2 2 2 4 4 4 4 4 4 4 4 4 4 4 4 4 4 4 4 4 4 4
4 4 4 4 4 4 4 4 4 4 4 4 4 4 4 4 4 2 2 2 2 2 2 2 2 2 2 2 2 2 4 4 4 4 4 4 4 4 4 4 1 4 4 4 4 4 4 4 4 4
4 4 4 4 4 4 4 4 4 4 4 4 4 4 4 4 4 4 2 2 2 2 2 2 2 2 2 2 2 6 4 4 6 4 4 6 1 4 4 4 4 4 4 4 4 4 4 6 4 4
4 4 4 4 4 4 4 4 4 4 4 4 4 4 4 6 4 4 2 2 2 2 2 2 2 2 2 2 6 4 4 4 4 4 4 4 4 4 1 4 4 1 4 4 4 4 4 4 4 4
4 4 4 4 4 4 4 4 4 4 4 4 4 4 4 4 4 4 4 4 4 1 4 4 4 1 4 4 4 4 4 4 1 4 4 4 4 6 4 4 4 4 1 4 1 4 4 4 4 4
4 4 4 4 4 4 4 4 7 6 7 6 2 2 2 2 2 2 2 2 2 2 2 2 2 2 2 4 4 1 4 4 4 6 4 4 4 1 4 4 4 4 4 4 4 4 4 4 4 4
4 4 4 4 4 4 1 4 6 0 0 0 2 2 2 2 2 2 2 2 2 2 2 2 2 2 2 4 6 4 4 4 4 4 2 2 2 2 2 2 2 2 4 4 1 4 4 4 4 4
4 4 4 4 4 1 4 4 7 0 0 0 2 2 2 2 2 2 2 2 2 2 2 2 2 2 6 4 4 4 6 6 1 4 2 2 2 2 2 2 2 2 4 4 4 4 4 4 4 4
4 4 4 4 4 4 4 4 6 0 0 0 6 4 4 4 4 4 4 4 4 4 3 3 3 4 4 4 6 4 4 4 4 4 2 2 2 2 2 2 2 2 4 4 4 4 4 4 4 4
4 4 4 4 1 4 4 4 7 0 0 0 7 4 1 6 4 6 1 4 6 1 4 3 4 4 6 4 6 4 4 3 4 4 2 2 2 2 2 2 2 2 4 4 4 4 4 4 4 4
4 4 4 4 4 4 4 4 6 7 0 7 6 4 4 4 4 4 4 6 4 4 4 3 4 4 4 4 6 4 3 3 3 4 2 2 2 2 2 2 2 2 4 4 4 4 4 4 4 4
4 4 4 1 4 4 4 4 4 4 0 4 4 4 4 6 4 4 6 6 4 4 4 3 4 4 6 4 4 3 3 3 3 3 6 2 2 2 3 2 2 2 4 4 4 4 4 4 4 4
4 4 4 4 4 4 6 1 4 6 0 4 4 4 4 4 4 6 1 4 1 4 4 3 4 4 4 6 3 3 3 3 3 3 3 4 4 2 3 2 6 4 4 6 4 4 4 4 4 4
4 4 4 1 4 4 6 4 4 4 0 6 6 1 4 6 4 6 4 6 4 4 4 3 4 1 4 3 3 3 3 3 3 3 3 3 4 4 3 4 4 4 4 4 4 4 4 4 4 4
4 4 4 4 4 4 4 6 4 4 0 4 4 4 4 4 6 4 1 4 6 4 4 3 4 4 6 3 3 3 3 3 3 3 3 3 4 4 3 4 4 4 4 1 4 4 4 4 4 4
4 4 4 4 4 1 4 4 0 0 0 4 6 4 6 4 6 4 4 6 4 4 4 3 4 1 6 4 3 3 3 3 3 3 3 4 4 4 3 4 1 4 1 4 4 4 4 4 4 4
4 4 4 4 4 4 4 6 0 4 4 4 6 6 4 6 1 4 4 6 1 4 4 3 6 6 4 4 6 3 3 3 3 3 4 6 4 4 3 4 4 6 4 4 4 4 4 4 4 4
4 4 4 1 4 4 4 4 0 4 4 4 6 4 4 6 6 4 6 4 4 4 0 3 0 6 4 4 6 4 3 3 3 4 4 4 3 3 3 4 6 1 4 6 4 4 4 4 4 4
4 4 6 4 6 4 4 4 0 4 4 4 4 4 4 4 4 4 4 4 4 0 0 3 0 0 4 4 4 6 1 3 4 4 4 4 3 4 4 4 4 6 4 4 4 4 4 4 4 4
4 4 4 4 4 1 4 4 0 4 6 4 6 4 4 6 1 4 4 4 0 0 3 3 3 0 0 6 6 4 4 3 4 4 4 4 3 1 4 4 4 1 4 1 4 4 4 4 4 4
4 4 4 4 6 4 4 4 0 4 4 4 3 3 3 3 3 3 3 3 3 3 3 3 3 3 3 3 3 3 3 3 3 3 3 3 3 4 4 4 4 4 4 4 4 6 4 4 4 4
4 4 4 1 4 6 4 6 0 4 4 4 3 4 4 6 6 4 4 6 0 0 3 3 3 0 0 4 4 4 4 4 4 4 4 4 3 4 4 1 6 4 6 4 4 4 4 4 4 4
4 4 4 4 4 4 4 4 0 4 4 4 3 6 4 4 6 4 4 1 4 0 0 3 0 0 4 4 6 4 4 1 4 4 4 4 3 4 4 6 6 4 4 4 4 6 4 4 4 4
4 4 4 4 4 6 4 4 0 4 4 4 3 4 4 4 4 6 4 4 6 4 0 3 0 4 4 4 4 4 4 4 4 1 4 4 3 4 6 1 4 4 4 6 4 4 4 4 4 4
4 4 4 6 4 1 4 4 0 4 1 4 3 3 3 6 4 6 1 6 4 1 4 3 1 4 4 1 6 4 4 4 4 4 4 4 3 4 4 4 4 1 4 4 4 4 4 4 4 4
4 4 4 4 6 4 4 6 0 4 4 4 4 4 3 4 4 4 1 1 4 4 4 3 4 4 4 4 4 1 4 1 4 4 4 4 3 4 4 4 4 4 4 4 4 4 4 4 4 4
4 4 4 4 4 6 4 4 0 4 4 4 4 4 3 4 4 2 2 2 2 4 4 3 1 4 4 6 4 4 4 4 4 4 4 4 3 4 4 4 4 4 4 4 4 4 4 4 4 4
4 4 4 4 4 4 4 4 0 4 4 1 4 4 3 4 4 2 2 2 2 4 4 3 4 4 6 4 1 4 6 4 4 1 4 4 3 4 1 4 6 6 4 4 4 4 4 4 4 4
4 4 4 4 4 6 4 4 3 3 3 3 3 3 3 4 6 2 2 2 4 4 4 3 4 4 4 4 4 4 6 4 4 4 4 4 3 4 4 4 4 4 4 4 4 4 4 4 4 4
4 4 4 4 4 4 4 4 3 3 3 3 3 3 3 4 4 2 2 2 2 4 4 3 4 4 2 2 2 2 4 4 4 4 4 4 4 4 6 4 4 6 4 4 4 4 4 4 4 4
4 4 4 4 4 4 4 4 3 2 2 2 2 2 3 4 4 2 1 1 2 2 2 3 2 2 2 1 1 2 1 4 4 4 4 0 0 0 4 1 4 4 4 4 4 4 4 4 4 4
4 4 4 4 4 6 4 4 3 2 2 2 2 2 3 4 6 2 2 2 2 2 2 3 2 2 2 2 2 2 4 1 4 6 4 0 0 0 4 4 4 6 4 4 4 4 4 4 4 4
4 4 4 6 4 4 4 6 3 3 3 3 3 3 3 6 4 4 4 4 4 4 4 3 4 4 4 4 2 2 6 4 4 4 4 0 0 0 4 4 1 4 4 6 4 4 4 4 4 4
4 4 4 6 4 4 4 4 3 3 3 3 3 3 3 4 4 4 6 4 6 4 4 3 4 4 4 4 2 2 2 2 4 1 4 0 0 0 4 4 4 4 4 4 4 4 4 4 4 4
4 4 4 6 4 4 4 4 4 4 6 3 6 4 4 4 4 4 4 4 4 4 4 3 4 4 1 4 4 4 2 2 4 4 4 0 0 0 6 6 4 6 4 6 4 4 4 4 4 4
4 4 4 4 4 4 6 4 4 4 4 3 4 4 4 6 4 4 4 0 0 0 0 0 0 0 0 4 4 4 2 2 1 4 0 0 0 0 0 4 1 4 4 4 4 4 4 4 4 4
4 4 4 6 4 4 4 4 4 4 4 3 4 6 4 4 1 4 0 0 0 0 0 0 0 0 0 0 6 4 2 2 1 0 0 0 0 0 0 4 4 6 6 4 4 4 4 4 4 4
4 4 4 4 4 4 4 4 4 4 4 3 4 4 4 1 4 6 0 0 0 0 0 0 0 0 0 0 4 4 2 2 0 0 0 0 0 0 0 4 4 4 4 4 4 4 4 4 4 4
4 4 4 4 4 6 4 6 4 4 4 3 4 6 4 4 6 4 0 0 0 0 0 6 0 0 0 0 0 4 2 2 0 3 3 0 0 3 0 4 4 4 4 4 4 4 4 4 6 4
4 4 4 6 4 4 4 4 4 4 4 3 4 4 1 6 4 6 0 0 0 0 0 0 0 0 0 0 0 0 0 0 0 0 3 0 3 0 0 4 4 4 6 4 4 4 4 4 4 4
4 4 4 4 4 6 4 6 4 4 4 3 4 6 4 6 4 4 4 0 0 0 0 0 0 0 0 4 6 4 0 0 0 0 3 3 3 3 6 4 4 6 4 4 4 4 4 4 4 4
4 4 4 4 4 4 4 4 4 6 4 3 6 4 4 4 4 6 4 1 0 0 0 0 0 0 4 4 4 4 4 0 0 3 0 3 3 3 4 4 4 4 6 4 4 4 4 4 4 4
4 4 4 4 6 4 4 4 4 4 4 3 3 3 4 6 4 6 4 4 4 4 3 6 4 6 4 4 6 4 4 4 0 0 0 3 3 3 4 4 4 4 4 4 4 4 4 4 4 4
6 4 4 6 4 4 4 6 4 4 4 4 4 3 4 4 4 4 4 4 4 4 3 4 4 4 6 4 4 4 4 4 4 4 4 6 4 4 4 6 4 6 4 6 4 4 4 4 4 3
4 4 4 4 4 4 4 4 4 4 4 3 3 3 3 3 4 4 4 4 4 4 3 6 4 4 4 4 4 6 4 4 4 4 4 4 6 4 4 4 4 4 4 4 4 6 4 4 4 4
4 4 4 4 4 6 4 4 6 4 4 3 3 3 3 3 3 3 3 3 3 3 3 4 4 4 6 4 4 4 4 1 4 4 4 4 4 4 4 6 4 4 4 4 4 4 4 4 4 4
4 4 4 6 4 4 4 4 4 4 4 3 3 3 3 3 4 4 4 4 4 4 6 4 4 4 4 4 4 6 4 4 4 4 4 6 4 4 6 4 4 6 4 4 4 4 4 4 4 4
4 4 4 4 4 6 4 4 6 4 4 4 6 4 4 6 4 4 6 4 4 6 4 4 4 1 4 4 4 4 4 4 6 4 4 4 4 4 6 4 4 4 4 6 4 4 4 6 4 4
4 4 4 4 4 4 4 4 4 4 4 4 4 6 4 4 4 4 4 4 4 4 4 4 4 4 4 4 4 4 4 4 4 4 4 4 4 4 4 4 4 4 4 4 4 4 4 4 6 4